0000000000
0000000000
0000000000
0000000010
2222300000
0000000000
0100000000
0000000000
0000000000
0000000000